12 12
4 4 4 4 4 4 4 4 4 4 4 4
4 0 0 1 0 0 0 0 3 0 0 4
4 0 4 4 4 0 4 0 4 4 0 4
4 0 0 0 4 0 4 0 0 4 0 4
4 4 4 0 4 0 4 4 0 4 0 4
4 1 0 0 0 0 0 4 0 0 0 4
4 0 4 4 4 4 0 4 4 4 0 4
4 0 4 0 0 0 0 0 0 4 0 4
4 0 4 0 4 4 4 4 0 4 0 4
4 0 0 0 3 0 0 0 0 0 2 4
4 0 4 4 4 4 4 4 4 0 0 4
4 4 4 4 4 4 4 4 4 4 4 4